11111111111
100P0000111
1C000000111
100000000E1
11111111111