111111
100P11
1C0011
100E11
111111