11111111111111
10001000P00011
10000111110011
10000E00000C11
11111111111111