1111111
100P111
1C00111
100E111
1111111