1111111111111111111111111
1000000000000000000000001
1011111111111111111111101
101P000010000000000001101
1010000001000000000011101
1010000010000000000000101
10100000000C0000000000101
1010000001000000000000101
1010000000100001000000101
1010000000000000000011101
1010000000001000000000001
1011111111111111111101111
10000000000000000000000E1
1111111111111111111111111
