1111111111111111111111111
1000000000000000000000001
1011111111111111111111101
101000001000C000000001101
1C10000C01000000C00011101
10100C0010000C00000000101
10100CCCC00C0000000000101
10100C00010C0000000000101
10100CCC001C0001000000101
10100C0000000000000011101
10100CCCC0001000000P00001
1011111111111111111111111
10000000000000000000000E1
1111111111111111111111111